###########.###...##.............#.........#######...############
##########..#.................................####...#..#########
##########...................................#####.........###.##
#########......................................#................#
##########..##........................................#.........#
###################.................................###.........#
#############.....#.................................###.#.......#
#############.....#...............................#..#..#.......#
############..#...#...............................#..#....#...#.#
###################.....................................#.#..##.#
#############...#.#####.............................####.#...####
#############...#.....#.................................##...####