##############................##################################
#############............<....##################################
#############.................##################################
#############................###############.######...##########
#############...............>################...####.#.#########
##################.###########################.######.##########
##################.###########################.######.##########
###################....############...........######..##########
####################.##############..................#..########
#####################.############............######..##########
######################........................#######.....######
################################################################