###########....##....#################################.....######
##.............##....############....#################.....###...
##.............##....############....#....############....<###...
.....................###########..........##########>...######...
.......##..........#....########..........#######.......###......
........#..........#....########...............##.......###......
#.......#....##....#.......################..............##......
#.......###############.....###########....................##....
.....############....#......########......................######.
....#############...............####......................####...
....#############....#..................................######...
#....####################.................#####.........######...