#######..########################################################
######...#############..#########################################
######...###########.#....#######################################
######....#######.#.........#############.####...################
#######.......##............########.##.....#....#######.########
######x....................########....#..........###......######
#######.#......##...........#######.............#...##.x...######
######...#.........#.........###......##..###..####........######
#######.........#...##....#.####..#.##############.....##.#######
#######....#.........#...#..##...#################..#############
#########..............###..#.....###############################
##########.####........####...#....##############################