#################################################################
#############################################################..##
##############################################################.##
###############..######################################.##.#...##
###############...####################################..##.....##
################..##..##############..############.#.........####
################.........#########....###..#####........###.#####
##################..........#####...........#.......#######.....#
####################..##..#..........................######.###..
####################.....######..###.................############
#####################.....###############.......#..##############
######################...####################..##################